*******
*X * W* 	
*     *
* F   *   
**Y****


