***********
*X        *
*  ****** *
*  ***WF* *
*     FF*W*
*******Y***


