****************
*X      2 *  W *
*  *** ** **** *
*  * WW*   1   *
*  ***** ***** *
*   2 *   ** *F*
*W **W***   FFF*
*  1********FFF*
**************Y*


