****************
*X      2 *W   *
*  *** ** **** *
*  *  W*   1   *
*  ***** ***** *
*   2 *   ****F*
*  ** ***  F   *
*  1********FF *
*************Y**







