***************************
*X           F      W*    *
*  ******** ***** ***** * *
*  W*     * *W*1* *****W* *
*  ** *** * *     ******* *
*  *  *FF *F***********W* *
*    **F*** *2*           *
*  ****F*** * * **** ******
*  *WWW ***   *   **     W*
*  *WW 2*** ***** ** ******
*  *******   FFF*W**  FF W*
*     *WW* ****F*W** ***WW*
*  **F**W* ****F**** ****** 
*  1*F   *W****F      FFFF*
************************Y**
